{
  "name": "Jump and Shoot",
  "ammo": 6,
  "map": [
    "........................................",
    ".......................................G",
    "................................E.....11",
    "............................A11111......",
    "..........................E.11..........",
    ".........................1111...........",
    "........................................",
    ".................E......................",
    "................111.....................",
    "...............A1.......................",
    "..............111.......................",
    "........................................",
    "........................................",
    "........................................",
    "........................................",
    ".......E111.............................",
    "......111...............................",
    "........................................",
    "........................................",
    "........................................",
    "...P....................................",
    "..111..................................."
  ]
}