{
  "name": "Vertical Climb",
  "ammo": 4,
  "map": [
    "........................................",
    ".....................G..................",
    "...................11111................",
    "....................111.................",
    ".............E..........................",
    "...........11111........................",
    "..........1111..........................",
    "......A.11111................E..........",
    ".....1111111...............1111..AA.....",
    "......11111.................1111111111..",
    ".....................A........1111111...",
    "....................AAA.................",
    "..............11111111111...............",
    "..T............1111111111111............",
    "..T..............1111111111.......E.....",
    "...................11111.........1111...",
    "...............................11111....",
    "........................................",
    "........111................E............",
    ".......11111.E...1111111111111....A.....",
    "111.P.1111111111111111111111111..AAA..11",
    "1111111111111111111111111111111111111111"
  ],
  "texts": [
    {
      "row": 8,
      "col": 2,
      "content": "Collect extra ammo by picking some up!"
    },
    {
      "row": 13,
      "col": 2,
      "content": "Get extra ammo"
    },
    {
      "row": 14,
      "col": 2,
      "content": "by picking them up!"
    }
  ]
}