{
  "name": "tutorial",
  "ammo": 5,
  "map": [
    "........................................",
    "........................................",
    "........................................",
    "........................................",
    "........................................",
    "........................................",
    "........................................",
    "...................................F....",
    "........T.......................1111111.",
    ".................................11111..",
    "........................................",
    "........................................",
    "........................................",
    "..................1111111111111111111111",
    "..................1111111111111111111111",
    "..................1111111111111111111111",
    "..................1111111111111111111111",
    "..................1111111111111111111111",
    "........11111111111111111111111111111111",
    "........11111111111111111111111111111111",
    "...P....11111111111111111111111111111111",
    "1111111111111111111111111111111111111111"
  ],
  "texts": [
    {
      "row": 8,
      "col": 8,
      "content": "Use your shooting recoil to jump!"
    }
  ]
}