{
  "name": "Cave Hunting",
  "ammo": 10,
  "map": [
    "........................................",
    "........................................",
    "........................................",
    "............E...T...................G...",
    "...........111.....................111..",
    "..........1111....................11111.",
    "..........11111...................11111.",
    "..........11111...................11111.",
    "....P.....11111...................11111.",
    "..111...............S.............11111.",
    "..11111...11111...111.............11111.",
    "..11111...111.....1111............11111.",
    "..11111...11......1111............11111.",
    "..11111...11.A....11111...........11111.",
    "..11111...11......11111...........11111.",
    "..11111...111..............S......11111.",
    "..11111...11111...11111...111.....11111.",
    "..11111...11111...11111..111111...11111.",
    "..111.....11111...11111....11111..11111.",
    "..11......11111...11111....11111..11111.",
    "..11.S....................A11111..11111.",
    "..11111...11111...11111..1111111..11111."
  ],
  "texts": [
    {
      "row": 3,
      "col": 16,
      "content": "Some enemies can shoot you back!"
    }
  ]
}