{
  "name": "tutorial_2",
  "ammo": 5,
  "map": [
    "........................................",
    "........................................",
    "........................................",
    "........................................",
    "........................................",
    "........................................",
    "........................................",
    "...................................G....",
    "........T.......................1111111.",
    "........T........................11111..",
    "........................................",
    "........................................",
    ".............................E..........",
    "..................1111111111111111111111",
    "..................1111111111111111111111",
    "..................1111111111111111111111",
    "..................1111111111111111111111",
    ".............E....1111111111111111111111",
    "........11111111111111111111111111111111",
    "........11111111111111111111111111111111",
    "...P....11111111111111111111111111111111",
    "1111111111111111111111111111111111111111"
  ],
  "texts": [
    {
      "row": 8,
      "col": 8,
      "content": "Kill all enemies to unlock the gate!"
    },
    {
      "row": 9,
      "col": 8,
      "content": "Use your ammo wisely..."
    }
  ]
}