{
  "name": "Precision",
  "ammo": 12,
  "map": [
    "........................................",
    "........................................",
    "..F.....................................",
    "..1.....................................",
    "..1.....................................",
    "........................................",
    ".....1..................................",
    "........................................",
    "........1...............................",
    "........................................",
    "...........1............................",
    "...................E....................",
    "..............1..1111...................",
    "........................................",
    ".................E........A.............",
    "...............11111.....111............",
    "........................................",
    "......E.................................",
    "..P..1111...............................",
    "..1..1111...............................",
    "..1..1111...1111111....1111111111111111.",
    "1111111111111111111111111111111111111111"
  ]
}
