{
  "name": "Dungeon",
  "ammo": 10,
  "map": [
    "..................111...................",
    ".P................111.................G.",
    "111111111111111...111...1111111111111111",
    "..................111...................",
    ".......A..........111..........A........",
    ".....S....XX......XXX......XX....S......",
    "...1111111111111111111111111111111111...",
    "..................111...................",
    "..................111...................",
    "......XX.S........111.........S.XX......",
    "111111111111111...111...1111111111111111",
    "..................111...................",
    "......A....A......111......A....A.......",
    "..................111...................",
    "...E....S....E....XXX....E....S....E....",
    ".11111111111111111111111111111111111111.",
    ".11111111111111111111111111111111111111.",
    ".1................111.................1.",
    ".........A........111........A..........",
    "........................................",
    ".....X...S...X.....A.....X...S...X......",
    "111111111111111111...1111111111111111111"
  ],
  "texts": []
}