{
  "name": "Bounce to Kill",
  "ammo": 6,
  "map": [
    "111111111111............................",
    "111111111111............................",
    "11111111111....................E........",
    "11111111111...................111.......",
    "11111111111.............................",
    "11111111111.............................",
    "11111111111..........................E..",
    "1111111111..........................111.",
    "1111111111..............................",
    "1111111111..............................",
    "1111111111........................E.....",
    "1111111111.......................111....",
    "1111111111..................XXX.........",
    "1111111111.................X111X........",
    "1111111111.................11111X.......",
    "1111111111.................1..111X......",
    "1111111111.....................111......",
    "111111111......................111......",
    "111111111....................P.111......",
    "111111111....................1111.......",
    "111111111................G.11111........",
    "111111111...............11111..........."
  ],
  "texts": []
}